search=Поиск
goto=Перейти к
book=Книга
choose=Выбрать книгу
chapter=Глава
verse=Стих
more=Больше
favorites=Закладки
about=Про нас
abouttext=Когда при себе нету стандартной Библии.Когда ты забыл сумку.Теперь у тебя будет Библия всегда с собой.\n\nПеревел на русский - Дима Осадчий\n\nPhoneyBible Copyright 2007 Fred Nicollson. All rights reserved.
exit=Выход
mobible=PhoneyBible
chooseabook=Выбери книгу
addfav=Добавить в Заклади
delete=Удалить
back=Назад
results=Результаты
next=Следущая
serialnum=Серийный Номер
email=E-Mail
serial=Номер
enter=ОК
var:polish.command.ok=OK
var:polish.command.cancel=Отменить
var:polish.command.select=Выделить
var:polish.command.mark=Mark
var:polish.command.unmark=UnMark
var:polish.command.options=Опции
var:polish.command.delete=Удалить
var:polish.command.clear=Убрать
var:polish.title.input=Ввести
MIDlet-Description=Bible for your mobile phone
MIDlet-Name=PhoneyBible