search=Search
goto=Goto
book=Book
choose=Choose
chapter=Chapter
verse=Verse
more=More
favorites=Favorites
brokenfavorite=Invalid Favourite
about=About
abouttext=For those times when a regular bible just isnâ€™t suitable. For those times when you forgot your bag. Now you will always have your bible\n\nPhoneyBible Copyright 2010 Fred Cox. All rights reserved.\n\nFor support contact support@phoneybible.org\n\nThis program is free software: you can redistribute it and/or modify it under the terms of the GNU General Public License as published by the Free Software Foundation, either version 3 of the License, or (at your option) any later version.\n\nThis program is distributed in the hope that it will be useful, but WITHOUT ANY WARRANTY; without even the implied warranty of MERCHANTABILITY or FITNESS FOR A PARTICULAR PURPOSE.  See the GNU General Public License for more details.\n\nhttp://www.gnu.org/licenses/
exit=Exit
mobible=PhoneyBible
chooseabook=Choose A Book
addfav=Add Favourite
delete=Delete
back=Back
results=Search Results
next=Next
prev=Previous
serialnum=Serial Number
email=E-Mail
serial=Serial
enter=Enter
ok=OK
loading=Loading...
chooseaversion=Choose A Version
min=Minimise
var:polish.command.ok=OK
var:polish.command.cancel=Cancel
var:polish.command.select=Select
var:polish.command.mark=Mark
var:polish.command.unmark=UnMark
var:polish.command.options=Options
var:polish.command.delete=Delete
var:polish.command.clear=Clear
var:polish.title.input=Input
MIDlet-Description=Bible on mobile phone
MIDlet-Name=PhoneyBible