search=Busca
goto=Pasar
book=Libro
choose=Elegir libro
chapter=Capítulo
verse=Verso
more=Más
favorites=Predilecto
about=De nosotros
abouttext=Когда при себе нету стандартной Библии.Когда ты забыл сумку.Теперь у тебя будет Библия всегда с собой.\n\nПеревел на русский - Дима Осадчий\n\nPhoneyBible Copyright 2007 Fred Nicollson. All rights reserved.
exit=Salida
mobible=PhoneyBible
chooseabook=Elegir de libro
addfav=Juntar en predilecto
delete=Quitar
back=Volver atrás
results=Resultado del busca
next=Siguiente
serialnum=De serie número
email=E-Mail
serial=Número
enter=OК
var:polish.command.ok=OK
var:polish.command.cancel=Anular
var:polish.command.select=Subrayar
var:polish.command.mark=Mark
var:polish.command.unmark=UnMark
var:polish.command.options=Todavía más
var:polish.command.delete=Alejar
var:polish.command.clear=Retirar
var:polish.title.input=Poner
MIDlet-Description=Bible for your mobile phone
MIDlet-Name=PhoneyBible