search=Пошук
goto=Перейти до
book=Книга
choose=Обрати книгу
chapter=Глава
verse=Вірш
more=Більше
favorites=Закладки
about=Про нас
abouttext=Коли при собі немає щоденної Біблії.Коли ти забув сумку.Тепер в тебе буде Біблія завжди з тобою.\n\nперевел на украинский - Дмитро Осадчий\n\nPhoneyBible Copyright 2010 Fred Cox. All rights reserved.\n\nThis program is free software: you can redistribute it and/or modify it under the terms of the GNU General Public License as published by the Free Software Foundation, either version 3 of the License, or (at your option) any later version.\n\nThis program is distributed in the hope that it will be useful, but WITHOUT ANY WARRANTY; without even the implied warranty of MERCHANTABILITY or FITNESS FOR A PARTICULAR PURPOSE.  See the GNU General Public License for more details.\n\nhttp://www.gnu.org/licenses/
exit=Вихід
mobible=PhoneyBible
chooseabook=Обрати книгу
addfav=Додати в Заклади
delete=Видалити
back=Повернутися
results=Результати Пошуку
next=Наступна
serialnum=Серійний Номер
email=E-Mail
serial=Номер
enter=ОК
var:polish.command.ok=OK
var:polish.command.cancel=Скасувати
var:polish.command.select=Відилити
var:polish.command.mark=Mark
var:polish.command.unmark=UnMark
var:polish.command.options=Опції
var:polish.command.delete=Видалити
var:polish.command.clear=Прибрати
var:polish.title.input=Ввести
MIDlet-Description=Bible for your mobible phone
MIDlet-Name=PhoneyBible